NO ./textures/brick_azure.xpm
SO ./textures/brick_azure.xpm

EA ./textures/brick_azure.xpm
C 0,0,55
WE ./textures/brick_azure.xpm
F 255,0,0


111111
111110111    
100W00001   
110110111    
1111101     
1111101     
1111101     
1111101     
1111101     
1111101     
1111101     
1111101     
1111101     
1111101     
1111101     
1111101     
1111101     
1111101     
1111101     
1111101     
1111101     
1111101     
1111101     
1111101     
1111101     
1111101     
1111101     
1111101     
1111101     
1111101     
1111101     
1111101     
1111101     
1111101     
1111101     
1111101     
1111101     
1111101     
1111101     
1111101     
1111101     
1111101     
1111101     
1111101     
1111101     
1111101     
1111101     
1111101     
1111101     
1111101     
1111101     
1111101     
1111101     
1111101     
1111101     
1111101     
1111101     
1111101     
1111101     
1111101     
1111101     
1111101     
1111111      
