NO ./textures/brick_azure.xpm
SO ./textures/brick_azure.xpm
WE ./textures/brick_azure.xpm
EA ./textures/brick_azure.xpm

C 0,0,55
F 255,0,0

     1      
11111011    
100000S01   
11111001    
11111001     
11111001     
11111001     
11111001     
11111011     
11111011     
11111011    
11111011     
11111011     
11111011     
11111011     
11111011     
11111011     
11111011     
11111011     
11111011     
11111011     
11111011     
11111011     
11111011     
11111011 1    
1111101     
1111101     
1111101     
1111101     
1111101     
1111101     
1111101     
1111101     
1111101     
1111101     
1111101     
1111101     
1111101     
1111101     
1111101     
1111101     
1111101     
1111101     
1111101     
1111101     
1111101     
1111101     
1111101     
1111101     
1111101     
1111101     
1111101     
1111101     
1111101     
1111101     
1111101     
1111101     
1111101     
1111101     
1111101     
1111101     
1111101     
1111101     
1111101     
1111101     
1111101     
1111101     
1111101     
1111101     
1111101     
1111101     
1111101     
1111101     
1111101     
1111101     
1111101     
1111101     
1111101     
1111101     
1111101     
1111101     
1111101     
1111101     
1111101     
1111101     
1111101     
1111101     
1111101     
1111101     
1111101     
1111101     
1111101     
1111101     
1111101     
1111101     
1111101     
1111101     
1111101     
1111101     
1111101     
1111101     
1111101     
1111101     
1111101     
1111101     
1111101     
1111101     
1111101     
1111101     
1111101     
1111101     
1111101     
1111101     
1111101     
1111101     
1111101     
1111101     
1111101     
1111101     
1111101     
1111101     
1111101     
1111101     
1111101     
1111101     
1111101     
1111101     
1111101     
1111101     
1111101     
1111101     
1111101     
1111101     
1111101     
1111101     
1111101     
1111101     
1111101     
1111101     
1111101     
1111101     
1111101     
1111101     
1111101     
1111101     
1111101     
1111101     
1111101     
1111101     
1111101     
1111101     
1111101     
1111101     
1111101     
1111101     
1111101     
1111101     
1111101     
1111101     
1111101     
1111101     
1111101     
1111101     
1111101     
1111101     
1111101     
1111101     
1111101     
1111101     
1111101     
1111101     
1111101     
1111101     
1111101     
1111101     
1111101     
1111101     
1111101     
1111101     
1111101     
1111101     
1111101     
1111101     
1111101     
1111101     
1111101     
1111101     
1111101     
1111101     
1111101     
1111101     
1111101     
1111101     
1111101     
1111101     
1111101     
1111101     
111111      
