NO ./textures/brick_azure.xpm
SO ./textures/brick_azure.xpm
WE ./textures/brick_azure.xpm
EA ./textures/brick_azure.xpm

F 0,255,3
C 42,82,190


111
111
101
1011111111111111111111111111111
1000000000011000000000001000001
1001110101111011111110101011101
1010100000001010000000101010001
1S10101111111010111111101010111
1000000000001010000000001010001
1011111111111011111111111011101
1011111111111111111111111111111
1000000000010000000000010001111
1010101111111110111111111110111
1010101000000000100000000000101
1010101011111111101111111111101
1010101010000000000000000000001
1010101011111111111111111111111
10001010100000000000000000000001
11111010101011111111111111111001
1000001010101000000000000000001
1011111010101011111111111111111
1010000010101000000000000000001
1010111110101011111111111111101
1010100010101000000000001000101
1010101010101111111111101010101
1010101010101000000000101010101
1010101010101011111110101010101
1010101010101000000010101010101
1010101010101111111010101010101
1010101010100000001010101010001
1010101010111111101010101011111
1010101010000000101010101000001
1010101011111110101010111111101
1000001000000000100010000000101
1111111111111111111111111111101
                           1001
                           10001
0000                       11111
                           11111
