NO ./textures/C.xpm
SO ./textures/door.xpm
WE ./textures/guardian.xpm
EA ./textures/wall.xpm

F 0,128,0
C 42,82,190

111
1S1
1011111111111111111111111111111
1010000000001000000000001000001
1010111111101011111110101011101
1010100000001010000000101010001
1010101111111010111111101010111
1000100000001010000000001010001
1011111111111011111111111011101
1010000000000010000000000010001
1010101111111110111111111110111
1010101000000000100000000000101
1010101011111111101111111111101
1010101010000000000000000000001
1010101011111111111111111111111
1000101010000000000000000000001
11111010101011111111111111111001
1000001010101000000000000000001
1011111010101011111111111111111
1010000010101000000000000000001
1010111110101011111111111111101
1010100010101000000000001000101
1010101010101111111111101010101
1010101010101000000000101010101
1010101010101011111110101010101
1010101010101000000010101010101
1010101010101111111010101010101
1010101010100000001010101010001
1010101010111111101010101011111
1010101010000000101010101000001
1010101011111110101010111111101
1000001000000000100010000000101
1111111111111111111111111111101
                           10001
                           10001
                           11111
