NO ./textures/brick_azure.xpm
SO ./textures/trump_mewing.xpm
WE ./textures/brick_red.xpm
EA ./textures/brick_purple.xpm
C 42,82,190
F 0,34,60

 	
 	
 	
  
   
    
    
    
    
    
    
    
    
     
     
EA ./textures/brick_purple.xpm

111111111111
	111111111111	
111111111111
1000000000010	
10000000000111111		
11000000000000001		
1000000000S011111		
1000000000011
100000000001
111100001111
111100001
11111001		
11111001		
11111111
