NO ./textures/brick_azure.xpm
SO ./textures/trump_mewing.xpm
WE ./textures/brick_red.xpm
EA ./textures/brick_purple.xpm
C 42,82,190
F 0,34,6

 	
 	
 	
  
   
    
    
    
    
    
    
    
    
     
     
     
EA ./textures/brick_purple.xpm
111111111111
10S000000001
1000000000011111
11000000000000001
1000000000001111
100000000001
100000000001
111111111111
