NO ./textures/brick_azure.xpm
SO ./textures/trump_mewing.xpm
WE ./textures/brick_red.xpm
EA ./textures/brick_purple.xpm
C 42,82,190
F 0,34,6

 	
 	
 	
  
   
    
    
    
    
    
    
    
    
     
     
EA ./textures/brick_purple.xpm

111111111111
10S0000000010
10000000000111110
11000000000000001
10000000000011110
1000000000010
100000000001
111100001111
111100001
11111001
11111001
11111110
