NO ./textures/new/brick_azure.xpm
SO ./textures/new/brick_azure.xpm
WE ./textures/new/brick_azure.xpm
EA ./textures/new/brick_azure.xpm

F 0,128,0
C 42,82,190

111111111111
100000000001
100000000001111
10000N0000000001
100000000000111
100000000001
100000000001
111111111111
