NO ./textures/brick_red.xpm
SO ./textures/brick_azure.xpm
WE ./textures/brick_green.xpm
EA ./textures/brick_yellow.xpm

C 100,100,100
F 200,200,200

11111111111
10000000001
10000000001
10000000001
10000000001
10000N00001
10000001001
10000010101
10000001001
10000100001
11111111111
